1111111 S 111    1111111111
11111         1111111111111
1111     11   11111 F 11111
111   1   11   1111    1111
1111   11111   11    111111
111111111111      111111111
111111111111111111111111111
