1111111
1  1111
S 11111
1 11111
1  1111
11    F
1111111
