1111111111111111111
11111111111 1111111
S  11111111 11111F1
11 11111 11 111   1
11 111   11 11111 1
1   11 1 11 11111 1
1 1 11 1 11 11111 1
  1    1      111 1
1111111111111 111 1
1111111111111     1
1111111111111111111
