111111111111111111111 11
1111111111  111111 11 11
S  1111111  11111      F
11 11111 1   111   11111
11 111   11 11111 111111
1   11 1 11 11111 111111
1 1 11 1 11 11111 111111
  1    1      111 111111
1111111111111 111 111111
1111111111111     111111
111111111111111 11111111
